width 18
height 14
data
1 14 14 14 14 14 14 14 14 14 14 2 14 14 2 14 14 3
8 0 0 0 0 0 0 0 0 0 0 8 0 0 8 0 0 8
8 0 0 0 0 0 0 13 14 14 14 11 0 0 8 0 0 8
8 0 0 0 0 0 0 0 0 0 0 0 0 0 8 0 0 8
8 0 0 0 16 0 0 0 0 0 0 0 0 0 8 0 0 8
8 0 0 0 0 0 0 16 0 0 0 0 0 0 8 0 0 8
5 15 0 0 0 0 0 0 0 1 14 14 15 0 8 0 0 8
5 0 0 4 0 0 0 0 0 8 0 0 0 0 8 0 0 8
8 0 0 9 14 14 14 14 14 11 0 0 13 14 11 0 0 8
8 0 0 0 0 0 0 0 0 0 0 0 0 0 0 0 0 8
9 14 14 14 14 3 0 0 1 14 14 14 14 14 14 14 14 11
0 0 0 0 0 8 0 0 8 0 0 0 0 0 0 0 0 0
0 0 0 0 0 8 0 0 8 0 0 0 0 0 0 0 0 0
0 0 0 0 0 9 14 14 11 0 0 0 0 0 0 0 0 0
